00000000000000000000000000000000000000000000000000000000000000000000000000000000000000000000
00000000000000000000000000000000000000000000000000000000000000000000000000000000000000000000
00000000000000000000000000000000000000000000000000000000000000000000000000000000000000000000
00000000000000000000000000000000000000000000000000000000000000000000000222222222222000000000
00000000000000000000000000000000000000000022222220000000222222222000000111111111111000000000
00000000000000000000000000000000000000000011111111000000111111111000000000000000000000000000
00000000000000000000000000002222222200000000000000000000000000000000000000000000000000000000
00000000000222222000000000001111111100000000000000000000000000000000000000000000000000000000
00000000000111111000000000000000000000000000000000000000000000000000000000000000000000000000
00022220000000000000000000000000000000000000000000000000000000000000000000000000000000000000
22211110000000000022222000000000000000000000000000000000000000000000000000000000000000000000
11111112222222222211111222220000000000000002222222000000000000000000000000000000000000000000
11111111111111111111111111110000000000000001111111000000000000022222220000000000000000000000
11111111111111111111111111112222222222222221111111000000000000211111112222222000000000022222
11111111111111111111111111111111111111111111111111222222000000111111111111111200000000011111
11111111111111111111111111111111111111111111111111111111000000111111111111111122000000011111
11111111111111111111111111111111111111111111111111111111000000111111111111111111000000011111
11111111111111111111111111111111111111111111111111111111000000111111111111111111000000011111
11111111111111111111111111111111111111111111111111111111000000111111111111111111000000011111
11111111111111111111111111111111111111111111111111111111000000111111111111111111000000011111
11111111111111111111111111111111111111111111111111111111000000111111111111111111000000011111
11111111111111111111111111111111111111111111111111111111000000111111111111111111000000011111
